1111111111
1000000001
1000000001
1000000001
1000100001
1000100001
1000100001
1011110001
1010000111
1000000101
1000100101
1001100001
1000100001
100$100001
1111111111